0 0  0   0 0  0 0  0  0   0  0 0
0 20 20 20 2  4 2  1  20 20 20 0
0 20 20 20 1  4 2  1  20 20 20 0
0 20 20 20 1  4 2  1  20 20 20 0
0 4  4  4  0  0 0  0  1  2 1 0
0 1  1  4  0  0 0  0  1  4 1 0 
0 4  4  4  0  0 0  0  6  6 6 0 
0 3  4  4  0  0 0  0  1  4 1 0 
0 4  4  4  0  0 0  0  1  4 1 0 
0 2  2  2  0  0 0  0  1  4 1 0 
0 4  4  4  0  0 0  0  4  4 1 0 
0 1  1  4  0  0 0  0  3  3 1 0 
0 4  4  4  0  0 0  0  4  4 1 0 
0 6  6  6  0  0 0  0  2  4 1 0 
0 4  4  4  0  0 0  0  2  4 1 0 
0 4  4  4  0  0 0  0  2  4 1 0
0 20 20 20 1  2 4  1 20 20 20 0
0 20 20 20 1  2 4  1 20 20 20 0
0 20 20 20 1  2 4  1 20 20 20 0
0 0  0   0 0  0 0  0  0  0  0 0