0 4  1  2  2  4 2  20 20 20
0 4  4  4  1  4 2  20 20 20
0 1  1  4  1  4 2  20 20 20
0 4  4  4  0  0 0  1  2 1
0 1  1  4  0  0 0  1  4 1  
0 4  4  4  0  0 0  1  4 1  
0 4  4  4  0  0 0  1  4 1  
0 4  4  4  0  0 0  1  4 1  
0 2  2  2  0  0 0  1  4 1  
0 4  4  4  0  0 0  4  4 1  
0 1  1  4  0  0 0  4  4 1  
0 4  4  4  0  0 0  4  4 1  
0 4  4  4  0  0 0  2  4 1  
0 4  4  4  0  0 0  2  4 1  
0 4  4  4  0  0 0  2  4 1
0 20 20 20 1  2 4 20 20 20
0 20 20 20 1  2 4 20 20 20
0 20 20 20 1  2 4 20 20 20
